111111111111111111111111
10000000P000000000000000
1000E0000000C00000C00000
100000000000000000000000
111111111111111111111111