111111111111111111111111
10000000P000000000000001
1000E0000000C00000C00001
100000000000000001111111
111111111111111111