111111111111111111111111
10000000P000000001000001
1000E000000000001C100001
100000000000000001000001
111111111111111111111111