111111111111111111111111
100000010000000000000001
1000E0010000C00000C00P01
100000010000000000000001
111111111111111111111111