111111111111111111111111
10000000P000000000000001
1000E0000000000000000001
100000000000000000000001
111111111111111111111111