111111111111111111111111
10000000P000000 00000001
1000E0000000C00000C00001
100000000 00000000000001
111111111111111111111111