111111111111111111111111
100000000000000000000001
1000E0000000C00000C00001
100000000000000000000001
111111111111111111111111