1111111111111111
1P0C00E000000001
1000000000000001
1000000000000001
1000000000000001
1111111111111111