111111111111111111111111
10000000P000100000000001
1000E0000001C10000C00001
100000000000100000000001
111111111111111111111111