11111111111111
10P00000C00001
1000000E00001
10000000000001
11111111111111