111111111111111111111111
10000000P000000000000001
100000000000000000C00001
100000000000000E00000001
011111111111111111111111