11111111111111
10P00000C00001
10000000000011
100000000E0001
1111111111