111111111111111111111111
10000000P000000000000000
100000000000000000C00000
100000000000000E00000000
111111111111111111111111