1111111111111111111
1000C000000000000E1
10000000000C0000001
1011101110101010101
101C001010101010101
10111010101100101C1
1C10101010101010101
1011101110101011101
1000000000000000001
10C0000P00C00000001
1000000000000000001
1111111111111111111
