111111111111111111111
1000C0000000000000E01
10000000000C000000001
101110111010101010001
101C00101010101010001
10111010101100101C001
1C1010101010101010001
101110111010101110001
100000000000000000001
10C0000P00C0000000001
100000000000000000001
111111111111111111111
